=============..............................................
=============..............................................
=============..............................................
=====S=======..========.....============...................
=============..=========================...................
=============..========.....=========..=...................
=============..========.....=========..=...................
=============..========.....=========..=...................
========================================...................
=============..========.....=========..=...................
=============..........................=...................
...........................=============...................
...........................=============...................
...........................=============...................
...........................=============...................
..............==========================...................
..............========.....==========E==...................
..............========.....=============...................
..............========.....=============...................
.......................................=...................
.......................................=...................
.......................................=...................
.........&&&&..........................=...................
.........&&&&..........................=...................
.........&&&&..........................=...................
.........&&&&..........................=...................
.........&&&&&&&&&&&&&&&&&&&&&&&&&&&&&&....................
.........&&&&..............................................
...........................................................
...........................................................
...........................................................
...........................................................
...........................................................
...........................................................
...........................................................
...........................................................
...........................................................
...........................................................
...........................................................
