..........................................================..
...............................========...=**************=..
................===========....=******=====**************=..
................=*********=....=*************************=..
................=*********=....=******=====**************=..
................=*==============******=...=**************=..
....=======.....=*=......=************=...===========*====..
....=*****=======*========*========*===.............=*=.....
....=**********************=......=*=...............=*=.....
....=*****======***********=..=====*=====...........=*=.....
....=*****=....=***********=..=*********=...........=*=.....
....=*****=....=***********=..=*********=...........=*=.....
....=====*=....=============..=*=========...........=*=.....
........=*=...................=*=...................=*=.....
........=*=...................=*=.......=============*===...
........=*=...................=*=.......=***************=...
........=*=...................=*=.......=***************=...
........=*=.................===*======..=***************=...
........=*=.................=********=..=***************=...
........=*=============.....=********=..=***************=...
........=*************=.....=********=..=***************=...
........=*====********=.....=********=..=***************=...
........=*=..==========.....==========..=======*=========...
........=*=.................................===*========....
.========*===...............................=**********=....
.=**********=...............................=**********=....
.=**********=...............................=**********=....
.=**********=...............................=**********=....
.=**********=...............................=**********=....
.=**********=...............................=**********=....
.============...............................=**********=....
............................................============....
