............................................................
.............................**********.....................
.............................**********.....................
...............************************........***********..
.***************..***........**********........***********..
.***************..***........**********........***********..
.***************..***........**********........***********..
.***************.............**********........***********..
.***************.............*****************************..
......*......................**********........*............
......*..............................*.........*............
......*..............................*.........*............
.....***...........................******...***********.....
.....***...........................******...***********.....
.....***...........................******...***********.....
.....***...........................******...***********.....
.....***....................................***********.....
.....***....................................................
......*.....................................................
......*.....................................................
...***************..........................................
...***************..........................................
...***************..........................................
...***************..........................................
...***************..........................................
.............*..............................................
.............*..............................................
.........*******............................................
.........*******............................................
.........*******............................................
.........*******............................................
............................................................
