&&&&&&&&&&&&&..............................................
&&&&&&&&&&&&&..............................................
&&&&&&&&&&&&&..............................................
&&&&&&&&&&&&&..&&&&&&&&.....&&&&&&&&&&&&...................
&&&&&&&&&&&&&..&&&&&&&&&&&&&&&&&&&&&&&&&...................
&&&&&&&&&&&&&..&&&&&&&&.....&&&&&&&&&..&...................
&&&&&&&&&&&&&..&&&&&&&&.....&&&&&&&&&..&...................
&&&&&&&&&&&&&..&&&&&&&&.....&&&&&&&&&..&...................
&&&&&&&&&&&&&&&&&&&&&&&&&&&&&&&&&&&&&&&&...................
&&&&&&&&&&&&&..&&&&&&&&.....&&&&&&&&&..&...................
&&&&&&&&&&&&&..........................&...................
...........................&&&&&&&&&&&&&...................
...........................&&&&&&&&&&&&&...................
...........................&&&&&&&&&&&&&...................
...........................&&&&&&&&&&&&&...................
..............&&&&&&&&&&&&&&&&&&&&&&&&&&...................
..............&&&&&&&&.....&&&&&&&&&&&&&...................
..............&&&&&&&&.....&&&&&&&&&&&&&...................
..............&&&&&&&&.....&&&&&&&&&&&&&...................
.......................................&...................
.......................................&...................
.......................................&...................
.........&&&&..........................&...................
.........&&&&..........................&...................
.........&&&&..........................&...................
.........&&&&..........................&...................
.........&&&&&&&&&&&&&&&&&&&&&&&&&&&&&&....................
.........&&&&..............................................
...........................................................
...........................................................
...........................................................
...........................................................
...........................................................
...........................................................
...........................................................
...........................................................
...........................................................
...........................................................
...........................................................
