.................................&&&&&&&&..................
......................&&&........&&&&&&&&..................
&&&&&&&...............&&&........&&&&&&&&..................
&&&&&&&...............&&&&.......&&&&&&&&............&&....
&&&&&&&...............&&&&.......&&&&&&&&............&&....
..&...................&&&&.......&&&&&&&&...........&&&....
..&...................&&&&.......&&&&&&&&...........&&&....
..&......................&.......&&&&&&&&...........&&&....
..&......................&...........&..............&&&....
&&&&&&&&&&&&&&&&.........&...........&.........&&&&&&&&....
&&&&&&&&&&&&&&&&.........&...........&.........&&&&..&&....
&&&&&&&&&&&&&&&&.....&&&&&&&&&.....&&&&..............&&....
&&&&&&&&&&&&&&&&.....&&&&&&&&&.....&&&&....................
&&&&&&&&&&&&&&&&.....&&&&&&&&&.....&&&&....................
&&&&&&&&&&&&&&&&...................&&&&....................
&&&&&&&&&&&&&&&&...................&&&&....................
.........&.........................&&&&....................
.........&.................................................
.........&.................................................
.........&.................................................
.........&.................................................
.........&.................................................
.........&.................................................
.........&.................................................
.........&.................................................
.........&.................................................
.........&.................................................
........&&&&&&.............................................
........&&&&&&.............................................
........&&&&&&.............................................
...........................................................
...........................................................
...........................................................
...........................................................
...........................................................
...........................................................
...........................................................
...........................................................
...........................................................
