................................
................................
...............==========.......
...............=********=.......
...............=********=.......
...............=********=.......
...............=*========.......
...............=*=..............
...............=*=..............
...............=*=..............
.........=======*=..............
.........=*****=*=..======......
.........=*****=*=..=****=......
.........=*****=*=..=****=......
.........=*******=..=****=......
.........=*****===..=****=......
.........=**f**======****=......
.........=***************=......
.........=*****=========*=......
.........=*****=.......=*=......
.........=*=====.......=*=......
....======*=..==========*=======
....=******=..=****************=
....=******=..=****************=
....=******=..=****************=
....=******=..=****************=
....=******=..=****************=
....=******=..==*===============
....=*======...=*=..............
....=*=......===*===========....
....=*=......=*************=....
....=*=......=*****p*******=....
....=*=......=*************=....
....=*=......=*************=....
....=*=......=========*=====....
....=*=..............=*=........
....=*=..............=*=........
....=*=..............=*=........
....=*=..............=*=........
....=*=..............=*=........
....=*=..............=*=........
....=*=..............=*=........
=====*=..............=*=........
=*****=............===*==.......
=*****=............=****=.......
=*****=............=****=.......
=======............=****=.......
...................=****=.......
...................=****=.......
...................====*=.......
......................=*=.......
......................=*=======.
......................=*******=.
......................===*****=.
........................=*****=.
........................=*****=.
........................=======.
................................
................................
................................
