=...........................................................
.=..........................................................
..=.........................................................
...=........................................................
....=.......................................................
.....=......................................................
......=.....................................................
.......=....................................................
........=...................................................
.........=..................................................
..........=.................................................
...........=................................................
............=...............................................
.............=...................................=*=........
..............=..................................=*=........
...............=.................................=*=........
................=................................=*=........
.................=...............................=*=........
..................=..............................=*=........
...................=.............................=*=........
....................=............................=*=........
.....................=........................====*====.....
......................=.......................=*******=.....
.......................=......................=*******=.....
........................=............==========*******=.....
.........................=...........*****************=.....
..........................=..........==========*******=.....
...........................=..................=***p***=.....
............................=.................=*******=.....
.............................=................=========.....
..............................=.............................
...............................=............................