............................============....................
............................=**********=....................
..............===============**********=......=============.
===============************************=......=***********=.
=***************==***========**********=......=***********=.
=***************==***=......=**********=......=***********=.
=***************==***=......=**********=......=***********=.
=***************======......=**********========***********=.
=***************=...........=*****************************=.
======*==========...........=**********========*===========.
.....=*=....................=========*==......=*=...........
....==*==.........................===*====.====*========....
....=***=.........................=******=.=***********=....
....=***=.........................=******=.=***********=....
....=***=.........................=******=.=**f********=....
....=***=.........................=******=.=***********=....
....=***=.........................========.=***********=....
....=***=..................................=============....
....==*==...................................................
..====*============.........................................
..=***************=.........................................
..=***************=.........................................
..=***************=.........................................
..=***************=.........................................
..=***************=.........................................
..===========*=====.........................................
........=====*===...........................................
........=*******=...........................................
........=*******=...........................................
........=**p****=...........................................
........=*******=...........................................
........=========...........................................
