........============........................................
....=====**********=...............................======...
....=*****===******=....=================.======...=****=...
....=*****=.======*======***************=.=****=...=****=...
....=*****=......=**********************=.=****=...=****=...
....=*****=......======================*=.=****=...=****=...
....====*==...........................=*=.=****=...=****=...
.......=*=............................=*===****=...=****=...
.......=*=............................=********=...=****=...
.......=*=............................========*=====****=...
.......=*==============......................=**********=...
.......=**************=......................=====*======...
.=======*======*******=..........................=*=........
.=*********=..=*******=..........................=*=........
.=*********=..=*******=........=======.......=====*====.....
.=*********=..=*******=........=*****=.......=********=.....
.=*********=..=======*==========*****=.......=********=.....
.==*========........=****************=.......=********=.....
===*====............=*==========*****=.......=********=.....
=******=............=*=........=======.......=********=.....
=******=............=*=......................=********=.....
=******=............=*=......................========*=.....
=******=............=*=............................==*===...
=******=............=*=............................=****=...
========............=*=............................=****=...
................=====*=............................=****=...
................=*****=............................=****=...
................=*****=............................=****=...
................=*****=............................=****=...
................=*****=............................=****=...
................=======............................=****=...
...................................................======...
