............................................................
............................................................
................============================................
................=**************************=............... 
................=**************************=................
................=**************************=................
................=***********dd*************=................
................=***********dd*************=................
................=**************************=................
................=**************************=................
................=**************************=................
................=**************************=................
................=**************************=................
................=**************************=................
................=**************************=................
................============***=============................
.......................... =***=............................
.......................... =***=............................
.......................... =***=............................
.......................... =***=............................
.......................... =***=............................
.......................... =***=............................
.......................... =***=............................
.......................... =***=............................
.......................... =***=............................
.......................... =***=............................
...........................=*p*=............................
...........................=====............................
............................................................
............................................................
............................................................
............................................................