............................................................
............................................................
............................................................
............................................................
............................................................
............................................................
............................................................
............................................................
............................................................
............................................................
............................................................
............................................................
............................................................
.................................................=*=........
.................................................=*=........
.................................................=*=........
.................................................=*=........
.................................................=*=........
.................................................=*=........
.................................................=*=........
.................................................=*=........
..............................................====*====.....
..............................................=*******=.....
..............................................=*******=.....
.....................................==========*******=.....
.....................................*****************=.....
.....................................==========*******=.....
..............................................=***p***=.....
..............................................=*******=.....
..............................................=========.....
............................................................
............................................................