............=======.....==================......=========...
..===========*****=.....=****************=......=*******=...
..=***************=.....=*******======***=......=*******=...
..=**==============.....=*******=....===*========*******=...
..=**=..................=*******=......=****************=...
..=**=..................=*******=......==========*******=...
..=**=..................=*******=...............=*******=...
..=*==........=========.=*******=...............=*******=...
.==*=======...=*******=.=*******=...............====*====...
.=********=...=*******=.=*******=..................=*=......
.=********=====*******=.=*******=.................==*=......
.=********************=.=*******=.................=**=......
.=====*==============*===*******=.................=**=......
.....=*=............=***********=.................=**=......
.....=*=............=*===*******=.................=**=......
.....=*=...........==*===*******=.................=**=......
.....=*=...........=***==*******=.................==*=......
.....=*====........=***==========..................=*=......
.....=****=........=***=.=======...................=*=......
.....=****=........=***=.=*****=...................=*=......
.....=****=........=***=.=*****=...................=*======.
.....=****=........=***=.=*****=...................=******=.
.....======........=***=.=*****=...................=******=.
...................=***===*****=...................=******=.
...................=***********=...................=******=.
...................=***===*****=...................=******=.
...................=***=.=*****=...................=******=.
...................=***=.=======...................==*****=.
...................=***=............................=*****=.
...................=***=............................=*****=.
...................=***=............................=======.
...................=====....................................
