............................................................
............................................................
.............................***********....................
.............................***********....................
.............................***********....................
.............................***********....................
.............................***********....................
.......************..........***********....................
.......************..........***********....................
.......************..........***********....................
.......************..........***********....................
.......************.........................................
............................................................
..........**********........................................
..........**********........................................
..........**********........................................
..........**********........................................
............................................................
..........*********.........................................
..........*********.........................................
..........*********.........................************....
..........*********.........................************....
..........*********.........................************....
..........*********................****.....************....
...................................****.....................
...................................****.....................
.................********..........****.....................
.................********..........****.....................
.................********..........****.....................
.................********..........****.............******..
.................********...........................******..
.................********...........................******..
..*********.........................................******..
..*********.........................................******..
..*********.................................................
..*********.................................................
............................................................
............................................................
............................................................
............................................................
