=============..............................................
=============..............................................
=============..............................................
=====S=======..========.....============...................
=============..=========================...................
=============..========.....=========..=...................
=============..========.....=========..=...................
=============..========.....=========..=...................
========================================...................
=============..========.....=========..=...................
=============..........................=...................
...........................=============...................
...........................=============...................
...........................=============...................
...........................=============...................
..............==========================...................
..............========.....==========E==...................
..............========.....=============...................
..............&=======.....=============...................
..............&........................=...................
..............&........................=...................
..............&........................=...................
.........&&&&.&........................=...................
.........&&&&.&........................=...................
.........&&&&.&........................=...................
.........&&&&.&........................=...................
.........&&&&&&&&&&&&&&&&&&&&&&&&&&&&&&....................
.........&&&&&.............................................
...........................................................
...........................................................
...........................................................
...........................................................
...........................................................
...........................................................
...........................................................
...........................................................
...........................................................
...........................................................
...........................................................
