...........................................................
...........................................................
.......****................................................
.......****......*******................***................
.......****......*******................***................
.......****......*******................***................
.......****......*******................***................
.......****......*******...................................
.......****......*******...................................
.****..****......******E...................................
.****..****......*******................****...............
.****..****......*******................****...............
.****..****......*******................****...............
.****..****......*******................****...............
.****..****......*******................****.......*******.
.......****......*******................****.......*******.
.......****......*******................****.......*******.
.......****.............................****.......*******.
.......****.............................****.......*******.
.......****................................................
...........................................................
...........................................................
.....................................********..............
.....................................********..............
.....................................******S*..............
.....................................********..............
.....................................********..............
...........................................................
...........................................................
...........................................................
...........................................................
...........................................................
....................***************........................
....................***************........................
....*************...***************........................
....*************..........................................
....*************..........................................
....*************..........................................
...........................................................
