..................................................
..................................................
..................................................
..................................................
.======...........................................
.=####=.........................========..........
.=##s#=.........................=######=..........
.=####=.............=============######=..........
.===#==.............=##################=..........
...=#=..............=#===========######=..........
...=#=..............=#=.........=######=..........
.===#======.........=#=.........=====#==..........
.=########=.........=#=.............=#=...........
.=########=.......===#===...........=#=...........
.=########=========#####=...........=#=...........
.=######################=...........=#=...........
.=########=========#####=...........=#=...........
.==========.......===#===...........=#=...........
....................=#=.............=#=...........
....................=#=.............=#=...........
....................=#=.............=#=...........
....................=#=.........=====#=======.....
....................=#=.........=###########=.....
...==================#===========###########=.....
...=########################################=.....
...=#########====================###########=.....
...=#########=..................=###########=.....
...=#########=..................=============.....
...=#########=....................................
...=#########=....................................
...=#########=....................................
...=#########=....................................
...=####f####=....................................
...=#########=....................................
...===========....................................
..................................................
..................................................
..................................................
..................................................
..................................................