............................................................
............................**********......................
............................**********......................
..............****..........**********......................
..............****..........**********......................
..............****..........**********......................
..............****..........**********......................
..............****..........**********......................
..............****..........**********......................
..............****..........**********......................
............................................................
............................................................
...............................******................*****..
...............................******.**********.....*****..
...............................******.**********.....*****..
...............................******.**********.....*****..
...............................******.**********.....*****..
...............................******................*****..
...............................******................*****..
............*****..............******.......................
............*****...........................................
...******...*****...........................................
...******...*****...........................................
...******...*****...........................................
...******...*****...........................................
...******...*****...........................................
...******...*****...........................................
...******...*****...........................................
...******...*****...........................................
...******...................................................
............................................................
............................................................
..............................................******........
......................************............******........
......................************............******........
......................************............******........
......................************............******........
......................************............******........
......................************............******........
............................................................
